107
45
0,0,1,16,1,1,1,1,1,1,1,1,1,1,1,1,1,1,1,1,1,1,1,1,1,1,1,1,254,12,1,0,0,0,0,0,0,0,0,0,0,0,0,1,1,1,1,1,1,1,1,1,1,1,1,1,1,1,1,1,1,1,1,1,1,1,1,1,1,1,1,1,1,1,1,1,1,1,1,88,84,84,84,84,84,84,84,84,84,84,89,254,1,1,1,1,1,1,1,1,1,1,1,79,1,0,0,
0,0,1,16,0,0,0,0,0,0,0,0,0,0,0,0,0,0,0,0,0,0,0,0,0,0,0,0,0,12,1,0,0,0,0,0,0,0,0,0,0,0,0,1,1,0,0,0,0,0,0,0,0,0,0,0,0,0,0,0,0,0,0,0,0,0,0,0,0,0,0,0,0,0,0,0,0,0,0,0,0,0,0,0,0,0,0,0,189,0,254,254,0,0,0,0,0,0,0,0,0,0,0,79,1,0,0,
0,0,1,16,0,0,0,0,0,0,0,0,0,0,0,0,0,0,0,0,0,0,0,0,0,0,0,0,0,12,1,0,0,0,0,0,0,0,0,0,0,0,0,1,16,254,0,0,0,0,0,0,0,0,0,0,0,0,0,0,0,0,0,0,0,0,0,0,0,0,0,0,0,0,0,0,0,0,0,0,0,0,0,0,0,0,0,0,237,0,254,0,0,0,0,0,0,0,0,0,219,0,0,79,1,0,0,
0,0,1,16,0,0,0,0,0,0,0,0,0,0,0,0,0,0,0,0,0,0,0,0,0,0,0,0,0,12,1,0,0,0,0,0,0,0,0,0,0,0,0,1,17,254,0,0,0,0,0,0,0,0,0,0,293,0,0,0,0,0,0,0,0,0,0,0,0,0,0,0,0,0,0,0,0,0,0,0,0,0,0,254,25,31,0,227,0,254,254,0,0,0,0,0,0,0,0,0,220,0,0,79,1,0,0,
0,0,1,16,206,205,0,0,0,0,0,0,0,0,0,0,0,0,0,0,0,0,0,0,0,0,0,0,0,12,1,0,0,0,0,0,0,0,0,0,0,0,0,1,17,0,0,0,0,0,0,0,267,0,286,289,285,282,207,0,0,0,0,0,0,0,0,0,0,203,0,0,0,0,0,0,0,0,0,203,0,0,0,254,27,29,0,0,254,254,0,0,0,0,0,0,0,0,0,0,220,0,0,79,1,0,0,
0,0,1,16,206,0,0,0,0,267,0,0,0,0,0,0,288,0,0,0,0,204,0,0,267,0,0,0,0,12,1,0,0,0,0,0,0,0,0,0,0,0,0,1,17,0,0,0,0,0,0,0,0,282,272,283,272,285,286,282,0,0,0,0,0,0,0,0,0,200,0,0,0,0,0,0,0,0,0,200,0,0,0,254,27,29,0,0,254,0,0,0,0,0,0,0,0,0,0,0,220,0,0,79,1,0,0,
0,0,1,16,205,0,0,0,0,0,0,0,0,208,292,0,206,0,206,0,0,200,0,0,0,0,0,0,207,12,1,0,0,0,0,0,0,0,0,0,0,0,0,1,17,0,0,0,0,0,204,0,0,286,289,285,282,286,272,292,0,0,0,0,0,0,0,0,0,0,195,195,0,0,0,0,195,0,212,0,248,0,0,254,33,35,0,254,254,0,0,0,0,0,0,0,0,0,0,0,221,0,254,79,1,0,0,
0,0,1,16,0,0,0,0,0,0,0,0,206,289,206,289,284,292,289,293,205,0,0,0,0,0,0,207,206,12,1,0,0,0,0,0,0,0,267,0,0,0,0,1,17,0,0,0,0,0,200,0,205,286,287,282,272,288,282,286,205,0,0,0,0,0,0,0,8,9,9,9,9,9,9,9,9,9,9,9,9,9,9,9,9,9,9,20,254,0,0,0,0,0,0,0,0,0,0,0,221,0,254,79,1,0,0,
0,0,1,16,254,0,0,0,0,0,204,0,0,205,291,206,206,205,206,0,289,208,0,0,0,0,0,205,206,12,1,0,0,1,1,1,1,1,1,1,0,0,0,1,17,0,0,0,0,0,0,0,0,283,272,291,290,283,272,283,0,0,0,0,0,0,0,0,12,14,1,61,61,61,61,61,61,61,61,61,61,61,61,61,61,1,1,16,0,0,0,0,0,0,0,0,0,0,0,0,220,0,0,79,1,0,0,
0,0,1,17,254,254,0,0,0,0,200,0,0,293,206,205,290,289,272,206,282,276,0,0,0,0,0,0,208,12,1,0,1,1,15,1,1,1,15,1,1,0,0,1,17,0,0,0,0,0,0,0,0,0,289,272,280,282,286,0,0,0,0,0,0,0,8,9,1,1,76,0,189,0,194,0,0,189,0,0,0,0,0,189,193,79,1,16,0,286,0,0,0,0,0,0,203,0,0,208,220,0,0,79,1,0,0,
0,0,1,19,9,20,0,0,0,0,0,0,291,206,0,206,280,206,289,282,278,189,0,0,0,0,0,0,0,12,14,1,1,16,0,11,15,18,0,12,1,1,1,14,17,0,0,0,0,0,0,0,0,0,0,0,277,278,0,0,0,0,0,0,8,9,1,1,1,1,76,0,189,0,0,0,0,237,0,0,0,0,0,189,192,78,1,18,283,285,0,0,0,0,0,0,200,0,205,206,220,0,0,79,1,0,0,
0,0,1,1,1,17,0,0,0,0,0,0,0,0,205,276,272,205,208,0,0,189,0,0,0,0,0,0,0,11,15,15,15,18,0,0,0,0,196,11,15,15,15,15,18,0,0,0,0,0,0,0,0,0,0,291,279,0,0,204,0,0,0,0,12,14,1,0,0,1,76,0,189,0,0,190,212,0,244,249,0,0,0,193,192,26,32,0,0,0,0,0,0,0,0,0,0,0,286,207,220,0,258,79,1,0,0,
0,0,1,1,1,17,0,0,0,0,0,0,206,0,208,0,277,283,293,0,0,189,0,0,0,0,0,0,0,0,198,0,0,0,0,0,0,0,0,0,199,0,0,0,0,0,0,0,0,0,0,203,0,0,0,0,280,0,0,200,0,0,0,0,12,1,1,0,0,1,16,0,189,0,0,80,73,73,73,73,75,0,0,0,0,28,30,0,203,0,0,0,0,0,0,0,0,0,0,207,220,80,73,1,1,0,0,
0,0,1,1,1,16,0,0,0,0,0,0,0,0,0,0,279,0,0,0,0,231,0,0,0,0,0,0,0,0,0,0,0,0,0,0,0,0,0,0,0,0,0,0,0,0,0,0,0,0,0,200,0,0,0,0,277,0,0,0,0,0,0,0,12,1,0,0,0,1,76,0,0,0,0,79,1,1,1,1,76,0,0,0,0,28,30,0,200,0,0,0,0,0,0,0,0,0,0,0,220,79,1,1,1,0,0,
0,0,1,1,1,18,0,0,0,0,0,0,0,0,0,0,280,0,0,0,0,0,0,0,0,204,0,0,0,0,0,0,0,0,0,0,0,0,0,0,0,0,0,0,0,0,0,0,0,195,0,195,195,0,195,292,281,293,0,0,0,195,0,0,12,1,0,0,0,1,76,192,194,0,0,79,1,1,1,1,76,0,201,0,0,34,36,0,0,195,247,0,0,0,0,0,0,0,0,0,220,79,1,1,1,0,0,
0,0,1,1,17,198,0,0,0,0,0,0,204,0,0,0,281,0,0,0,0,0,0,0,0,200,0,0,0,0,0,0,0,0,0,0,0,0,0,203,0,0,0,0,0,0,0,8,9,9,9,9,9,9,9,9,9,9,73,9,9,9,9,9,10,1,0,0,0,1,76,192,193,0,0,79,1,1,1,1,76,0,200,0,0,80,9,9,9,9,9,9,20,0,0,0,0,254,80,75,220,79,1,0,0,0,0,
0,0,1,1,17,0,0,0,0,245,0,234,200,0,0,0,290,195,0,0,0,0,0,0,253,0,241,195,195,0,0,0,0,0,0,0,0,195,195,200,0,0,0,0,0,0,0,13,1,1,1,1,1,1,1,1,1,1,1,1,1,1,1,1,1,1,0,0,0,1,16,0,0,0,0,79,1,1,1,1,76,0,0,0,0,79,1,1,1,1,1,1,16,0,0,0,0,0,12,76,220,79,1,0,0,0,0,
0,0,1,1,19,9,9,9,9,9,9,9,9,9,9,9,9,9,9,9,9,20,94,94,8,9,9,9,9,9,9,9,20,0,0,0,8,9,9,9,9,9,9,9,9,20,0,13,1,1,1,1,1,1,1,1,1,1,1,1,1,1,1,1,1,1,0,0,0,1,76,0,0,0,0,78,61,61,61,61,77,0,0,0,0,13,1,1,0,0,271,1,1,20,0,0,0,0,12,76,221,79,1,0,0,0,0,
0,0,1,1,1,1,1,1,1,1,1,1,1,1,1,1,1,1,1,1,14,17,94,94,13,1,1,1,1,1,1,1,16,43,39,49,12,14,1,1,1,1,1,1,1,1,9,1,1,1,1,1,1,1,14,15,15,15,15,15,15,15,15,15,14,0,0,0,0,1,76,0,0,0,193,192,192,192,192,192,193,0,0,0,194,79,1,0,0,0,0,0,1,17,0,0,0,0,12,76,221,79,1,0,0,0,0,
0,0,0,0,0,0,267,0,0,0,0,0,0,0,0,0,267,0,0,0,1,16,0,0,12,1,0,0,0,0,0,0,16,51,41,53,12,1,1,1,1,1,1,1,1,1,1,1,14,15,15,15,15,15,18,0,0,0,0,198,0,0,199,0,0,0,0,0,0,1,76,0,0,0,0,193,194,0,0,0,0,0,0,193,192,79,1,0,0,0,0,0,1,17,0,0,227,0,12,76,220,79,1,0,0,0,0,
0,0,0,0,0,0,0,0,0,0,0,0,0,0,0,0,0,0,0,0,1,17,0,0,12,1,0,0,0,0,0,0,16,0,0,0,12,1,1,1,1,1,1,1,1,1,1,1,16,0,0,0,0,0,0,0,0,0,0,0,0,0,0,0,0,0,0,0,0,1,76,190,0,0,0,0,0,0,0,0,190,0,0,194,192,79,1,1,1,1,1,0,1,17,0,195,273,0,12,76,220,79,1,0,0,0,0,
0,0,0,0,0,0,0,0,0,0,0,0,0,0,0,0,0,0,0,0,1,17,0,0,12,1,0,0,0,0,0,0,16,0,0,190,11,15,15,15,15,15,15,15,15,15,15,15,18,197,0,0,0,0,0,0,0,0,0,0,0,0,0,0,0,0,0,0,0,1,74,73,73,73,73,73,75,0,0,80,73,73,73,73,73,81,1,15,15,14,1,0,1,1,9,9,9,9,1,74,220,81,1,0,0,0,0,
0,0,0,0,0,0,0,0,0,0,0,0,0,0,0,0,0,0,0,0,1,16,0,0,13,1,0,0,0,0,0,0,16,0,191,192,189,0,0,0,199,0,0,0,0,0,0,0,198,0,0,0,0,0,0,193,0,0,0,0,191,193,0,0,0,191,0,0,0,0,1,1,1,1,1,1,76,0,0,79,1,1,1,1,1,1,0,189,0,12,1,0,1,1,1,1,1,1,1,1,220,0,1,0,0,0,0,
0,0,0,0,0,0,0,0,0,0,0,0,0,0,0,0,0,0,0,0,1,17,0,0,13,1,0,0,0,0,0,0,16,0,192,228,189,0,0,0,0,0,0,0,0,0,0,0,0,0,0,0,0,0,193,192,193,0,0,193,192,192,0,0,191,192,193,0,0,0,0,0,0,0,0,0,74,0,0,81,191,0,0,0,0,0,0,189,0,12,1,0,0,0,0,0,0,0,0,0,220,0,1,0,0,0,0,
0,0,0,0,0,0,0,0,0,0,0,0,0,0,0,0,0,0,0,0,1,17,0,0,13,1,0,0,0,0,0,0,1,20,191,192,236,0,0,0,0,0,0,0,0,0,0,0,0,0,0,0,0,191,192,214,192,193,191,192,214,192,193,193,192,214,192,193,0,0,0,0,0,0,0,0,0,0,0,191,192,193,0,0,0,0,0,236,0,12,1,0,0,0,0,0,0,0,0,0,220,0,1,0,0,0,0,
0,0,0,0,0,0,0,0,0,0,0,0,0,0,0,0,0,0,0,0,1,17,0,0,13,1,0,0,0,0,0,0,1,16,0,0,0,0,247,0,0,0,191,192,193,0,201,0,0,0,0,0,0,0,193,213,194,201,0,193,213,194,0,0,193,213,194,0,201,0,0,0,0,0,0,201,0,0,193,192,192,192,193,0,0,0,0,0,0,12,1,0,0,0,0,0,0,0,0,0,220,0,1,1,0,0,0,
0,0,0,0,0,0,0,0,0,0,0,0,0,0,0,0,0,0,0,0,1,17,0,0,13,1,0,0,0,0,0,0,1,1,9,20,0,0,0,234,0,191,192,192,192,194,200,0,195,0,0,0,0,0,0,213,0,200,0,0,213,0,195,195,0,213,0,0,200,0,0,234,0,0,0,200,0,195,0,193,214,194,0,0,0,195,235,195,0,12,1,0,0,0,0,0,0,0,0,0,221,0,0,1,0,0,0,
0,0,0,0,0,0,0,0,0,0,0,0,0,0,0,0,0,0,0,0,1,17,0,0,13,1,0,0,0,0,0,0,0,1,1,1,9,9,9,9,73,73,73,73,73,73,9,9,9,9,9,20,197,0,0,213,8,9,9,20,213,8,9,9,20,213,0,0,0,8,9,9,9,9,9,9,9,9,20,197,213,0,8,9,9,9,9,9,9,10,1,0,0,0,0,0,0,0,0,0,221,0,0,1,0,0,0,
0,0,0,0,0,0,0,0,0,0,0,0,0,0,0,0,0,0,0,0,1,17,250,0,13,1,0,0,0,0,0,0,0,0,1,1,1,1,1,1,1,1,1,1,1,1,1,1,1,1,1,16,0,0,0,213,12,14,1,16,213,12,1,1,16,213,0,0,196,11,14,1,1,1,1,1,1,1,16,0,213,0,12,14,1,1,1,1,1,1,1,0,0,0,0,0,0,0,0,0,220,0,0,1,1,0,0,
0,0,0,0,0,0,0,0,0,0,0,0,0,0,0,0,0,0,0,0,1,19,9,9,10,1,0,0,0,0,0,0,0,0,0,0,0,0,0,0,0,0,0,0,0,0,0,0,0,0,1,16,0,0,0,213,11,15,15,18,213,11,15,15,18,213,0,0,0,199,1,1,1,1,1,1,1,1,14,0,213,0,13,1,0,0,0,0,0,0,0,0,0,0,0,0,0,0,0,0,220,0,0,0,0,1,1,
0,0,0,0,0,0,0,0,0,0,0,0,0,0,0,0,0,0,0,0,1,1,1,1,1,1,0,0,0,0,0,0,0,0,0,0,0,0,0,0,0,0,0,0,0,0,0,0,0,0,1,16,0,0,222,215,224,0,0,222,215,224,0,0,222,215,224,0,0,0,0,0,0,0,0,0,0,0,0,222,215,224,0,0,0,0,0,0,0,0,0,0,0,0,0,0,0,0,0,222,223,224,0,0,0,0,1,
0,0,0,0,0,0,0,0,0,0,0,0,0,0,0,0,0,0,0,0,0,0,0,0,0,0,0,0,0,0,0,0,0,0,0,0,0,0,0,0,0,0,0,0,0,0,0,0,0,0,1,69,216,216,225,219,226,216,216,225,219,226,216,216,225,219,226,216,216,216,216,216,216,216,216,216,216,216,216,225,219,226,216,216,216,216,216,216,216,216,216,216,216,216,216,216,216,216,216,225,219,226,216,216,216,216,1,
0,0,0,0,0,0,0,0,0,0,0,0,0,0,0,0,0,0,0,0,0,0,0,0,0,0,0,0,0,0,0,0,0,0,0,0,0,0,0,0,15,15,15,15,15,0,0,0,0,0,1,69,218,218,218,218,218,218,218,218,218,218,218,218,218,218,218,218,218,218,218,218,218,218,218,218,218,218,218,218,218,218,218,218,218,218,218,218,218,218,218,218,218,218,218,218,218,218,218,218,218,218,218,218,218,218,1,
0,0,0,0,0,0,0,0,0,0,0,0,0,0,0,0,0,0,0,0,0,0,0,0,0,0,0,0,0,0,0,0,0,0,0,0,0,0,0,18,0,199,0,0,0,11,0,0,0,0,1,70,218,218,218,218,218,218,218,218,218,218,218,218,218,218,218,218,218,218,218,218,218,218,218,218,218,218,218,218,218,218,218,218,218,218,218,218,218,218,218,218,218,218,218,218,218,218,218,218,218,218,218,218,218,218,1,
0,0,0,0,0,0,0,0,0,0,0,0,0,0,0,0,0,0,0,0,0,0,0,0,0,0,0,0,0,0,0,0,0,0,0,0,0,0,17,0,0,0,0,0,0,198,13,0,0,0,1,1,217,217,218,218,218,218,218,218,218,218,218,218,218,218,218,218,218,218,218,218,218,218,218,218,218,218,218,218,218,218,218,218,218,217,218,218,218,218,218,218,218,218,218,218,218,218,218,218,218,218,218,218,218,217,0,
0,0,0,0,0,0,0,0,0,0,0,0,0,0,0,0,0,0,0,0,0,0,0,0,0,0,0,0,0,0,0,0,0,0,0,271,0,0,17,196,0,0,204,0,0,0,13,0,0,0,0,0,0,0,217,217,217,217,218,218,218,218,218,218,218,218,218,218,218,218,217,218,218,218,218,218,218,218,218,218,218,218,218,217,217,0,217,218,218,218,218,218,218,218,218,218,218,218,218,218,218,218,217,217,217,0,0,
0,0,0,0,0,0,0,0,0,0,0,0,0,0,0,0,0,0,0,0,0,0,0,0,0,0,0,0,0,0,0,0,0,0,0,0,0,0,17,0,0,0,200,0,0,0,13,0,0,0,0,0,0,0,0,0,0,0,218,218,218,218,218,218,218,218,218,217,217,217,0,217,218,218,218,218,218,218,218,218,218,218,218,0,0,0,0,217,217,217,217,218,218,218,218,218,218,218,218,218,218,217,0,0,0,0,0,
0,0,0,0,0,0,0,0,0,0,0,0,0,0,0,0,0,0,0,0,0,0,0,0,0,0,0,0,0,0,0,0,0,0,0,0,0,0,0,20,0,235,0,195,0,8,0,0,0,0,0,0,0,0,0,0,0,0,217,217,218,218,218,218,218,218,218,0,0,0,0,0,217,217,218,218,218,218,218,218,218,217,217,0,0,0,0,0,0,0,0,218,218,218,218,218,218,218,217,217,217,0,0,0,0,0,0,
0,0,0,0,0,0,0,0,0,0,0,0,0,0,0,0,0,0,0,0,0,0,0,0,0,0,0,0,0,0,0,0,0,0,0,0,0,0,0,0,9,9,9,9,9,0,0,0,0,0,0,0,0,0,0,0,0,0,0,0,218,218,218,217,217,217,217,0,0,0,0,0,0,0,217,217,217,217,217,217,217,0,0,0,0,0,0,0,0,0,0,217,217,218,218,217,217,217,0,0,0,0,0,0,0,0,0,
0,0,0,0,0,0,0,0,0,0,0,0,0,0,0,0,0,0,0,0,0,0,0,0,0,0,0,0,0,0,0,0,0,0,0,0,0,0,0,0,0,0,0,0,0,0,0,0,0,0,0,0,0,0,0,0,0,0,0,0,217,217,217,0,0,0,0,0,0,0,0,0,0,0,0,0,0,0,0,0,0,0,0,0,0,0,0,0,0,0,0,0,0,217,217,0,0,0,0,0,0,0,0,0,0,0,0,
0,0,0,0,0,0,0,0,0,0,0,0,0,0,0,0,0,0,0,0,0,0,0,0,0,0,0,0,0,0,0,0,0,0,0,0,0,0,0,0,0,0,0,0,0,0,0,0,0,0,0,0,0,0,0,0,0,0,0,0,0,0,0,0,0,0,0,0,0,0,0,0,0,0,0,0,0,0,0,0,0,0,0,0,0,0,0,0,0,0,0,0,0,0,0,0,0,0,0,0,0,0,0,0,0,0,0,
0,0,0,0,0,0,0,0,0,0,0,0,0,0,0,0,0,0,0,0,0,0,0,0,0,0,0,0,0,0,0,0,0,0,0,0,0,0,0,0,0,0,0,0,0,0,0,0,0,0,0,0,0,0,0,0,0,0,0,0,0,0,0,0,0,0,0,0,0,0,0,0,0,0,0,0,0,0,0,0,0,0,0,0,0,0,0,0,0,0,0,0,0,0,0,0,0,0,0,0,0,0,0,0,0,0,0,
0,0,0,0,0,0,0,0,0,0,0,0,0,0,0,0,0,0,0,0,0,0,0,0,0,0,0,0,0,0,0,0,0,0,0,0,0,0,0,0,0,0,0,0,0,0,0,0,0,0,0,0,0,0,0,0,0,0,0,0,0,0,0,0,0,0,0,0,0,0,0,0,0,0,0,0,0,0,0,0,0,0,0,0,0,0,0,0,0,0,0,0,0,0,0,0,0,0,0,0,0,0,0,0,0,0,0,
0,0,0,0,0,0,0,0,0,0,0,0,0,0,0,0,0,0,0,0,0,0,0,0,0,0,0,0,0,0,0,0,0,0,0,0,0,0,0,0,0,0,0,0,0,0,0,0,0,0,0,0,0,0,0,0,0,0,0,0,0,0,0,0,0,0,0,0,0,0,0,0,0,0,0,0,0,0,0,0,0,0,0,0,0,0,0,0,0,0,0,0,0,0,0,0,0,0,0,0,0,0,0,0,0,0,0,
0,0,0,0,0,0,0,0,0,0,0,0,0,0,0,0,0,0,0,0,0,0,0,0,0,0,0,0,0,0,0,0,0,0,0,0,0,0,0,0,0,0,0,0,0,0,0,0,0,0,0,0,0,0,0,0,0,0,0,0,0,0,0,0,0,0,0,0,0,0,0,0,0,0,0,0,0,0,0,0,0,0,0,0,0,0,0,0,0,0,0,0,0,0,0,0,0,0,0,0,0,0,0,0,0,0,0,


md.signDataVector.emplace_back( glm::ivec2{24, 16}, "Find the key and shoot it to the target to open the trapdoor");
md.signDataVector.emplace_back( glm::ivec2{76, 11}, "Be carreful, don't shoot with the key\nCome back if you lost it");
md.signDataVector.emplace_back( glm::ivec2{78, 6}, "This arrow can bounce on walls");


md.exitDataVector.emplace_back(glm::ivec2{22, 28}, 3);


md.torchDataVector.emplace_back(glm::ivec2{ 36, 24}, 5);
md.torchDataVector.emplace_back(glm::ivec2{ 88, 2}, 5);
md.torchDataVector.emplace_back(glm::ivec2{ 77, 10}, 2);
md.torchDataVector.emplace_back(glm::ivec2{ 69, 4}, 5);
md.torchDataVector.emplace_back(glm::ivec2{ 59, 11}, 5);
md.torchDataVector.emplace_back(glm::ivec2{ 88, 12}, 4);
md.torchDataVector.emplace_back(glm::ivec2{ 87, 24}, 5);
md.torchDataVector.emplace_back(glm::ivec2{ 82, 14}, 4);
md.torchDataVector.emplace_back(glm::ivec2{ 25, 14}, 5);
md.torchDataVector.emplace_back(glm::ivec2{ 12, 15}, 6);
md.torchDataVector.emplace_back(glm::ivec2{ 21, 5}, 7);
md.torchDataVector.emplace_back(glm::ivec2{ 10, 8}, 7);
