80
80
0,0,0,0,0,0,0,0,0,0,0,0,0,0,0,0,0,0,0,0,0,0,8,9,9,9,9,9,9,9,9,9,20,0,127,0,0,0,0,0,0,0,0,0,0,0,0,0,0,0,0,0,0,0,0,0,0,0,0,0,0,0,0,0,0,0,0,0,0,0,0,0,0,0,0,0,0,0,0,0,
0,0,0,127,0,127,0,127,127,0,0,0,0,0,0,0,0,0,0,0,0,0,11,14,1,1,1,1,3,1,1,1,19,9,9,20,0,0,0,0,0,0,0,0,0,0,0,0,0,0,0,0,0,0,0,0,0,0,0,0,0,0,0,0,0,0,0,0,0,127,0,0,0,0,0,0,0,0,0,0,
8,9,9,9,9,9,9,9,20,0,0,0,0,0,0,0,0,0,0,0,0,0,0,11,15,15,15,15,15,15,15,15,3,14,15,18,129,0,0,0,0,0,0,0,0,0,0,0,0,0,0,0,0,0,0,0,0,0,0,0,0,0,0,0,0,80,73,73,73,9,73,73,9,9,73,73,73,9,73,73,
12,1,1,1,6,1,14,15,18,0,0,0,0,0,0,0,0,0,0,0,0,0,0,0,0,131,0,130,131,0,0,0,12,17,0,0,0,0,0,0,0,0,0,0,0,0,0,0,0,0,0,0,0,0,0,0,0,0,0,0,0,0,0,0,0,79,7,1,1,1,1,1,1,1,1,1,1,1,1,1,
12,1,1,1,15,15,18,10,0,0,0,0,0,0,0,0,0,137,140,0,0,0,0,0,0,0,0,0,0,0,0,0,12,17,0,0,0,0,0,0,0,0,0,0,0,0,0,0,0,0,0,0,0,0,0,0,0,0,0,0,0,0,0,0,0,78,61,6,1,1,1,1,1,1,1,0,0,0,0,0,
12,1,1,16,130,131,0,0,0,0,0,0,0,0,0,0,0,0,139,137,138,137,0,0,127,127,127,167,127,0,0,0,12,17,0,0,0,0,0,0,0,0,0,0,0,0,0,0,0,0,0,0,0,0,0,0,0,0,0,0,0,0,0,0,0,0,0,79,1,1,1,1,1,1,1,0,0,0,0,0,
13,1,1,18,0,0,0,0,0,0,0,0,0,0,0,0,0,0,0,138,138,139,0,0,8,9,9,9,20,0,0,128,12,16,0,0,0,0,0,0,0,0,0,0,0,0,0,151,0,0,0,0,0,0,0,0,0,0,0,0,0,0,0,0,0,0,0,79,1,2,1,1,1,1,1,0,0,0,0,0,
12,1,17,0,0,0,0,0,140,138,0,0,0,0,0,0,0,0,0,0,0,0,0,0,12,3,1,1,17,129,0,0,12,17,0,0,0,0,0,0,0,0,0,0,0,0,0,152,0,0,0,0,0,0,0,0,0,0,0,0,0,0,0,0,0,0,0,79,1,6,1,1,1,1,1,0,0,0,0,0,
12,1,17,0,0,0,0,138,137,0,0,0,0,0,0,0,0,0,0,0,0,0,0,128,12,1,1,1,17,0,135,128,13,17,0,0,0,0,0,0,0,0,0,0,0,0,0,152,0,0,0,0,151,151,0,0,0,0,0,0,0,0,0,0,0,0,0,79,1,1,1,1,1,1,1,0,0,0,0,0,
13,1,17,0,0,0,0,0,0,0,0,0,0,0,0,0,0,0,0,0,0,0,0,0,13,1,1,14,17,129,132,0,12,17,0,0,0,0,0,0,0,0,0,0,0,0,0,152,0,0,0,0,152,152,0,0,0,0,0,0,0,0,0,0,0,0,0,79,2,1,1,1,1,1,1,0,0,0,0,0,
12,1,16,0,0,0,0,0,0,0,0,0,0,146,0,0,0,0,0,0,0,0,0,0,12,1,1,1,16,0,0,128,12,17,0,0,0,0,0,0,0,0,0,0,0,0,0,152,0,0,0,0,152,152,0,0,0,0,0,0,0,0,0,0,0,0,0,79,7,1,1,1,1,1,1,1,0,0,0,0,
13,1,17,0,0,0,136,0,0,136,0,0,0,145,0,136,0,0,136,0,0,0,0,0,13,1,1,1,17,129,0,0,12,17,0,0,0,0,0,0,0,0,0,0,0,0,0,152,0,0,0,0,152,152,0,0,0,0,0,0,0,0,0,0,0,0,0,79,1,1,1,1,1,1,1,1,0,0,0,0,
12,1,17,127,0,0,132,0,0,132,0,0,0,145,0,132,0,0,132,0,0,0,0,128,12,1,1,1,17,0,0,8,10,17,129,0,0,0,0,0,0,0,0,0,0,0,0,152,0,0,0,0,152,153,0,134,0,0,0,0,0,0,0,0,0,0,0,79,1,1,1,1,5,1,1,1,0,0,0,0,
12,1,19,20,127,127,127,177,127,175,127,172,0,147,166,127,127,175,175,127,173,127,175,0,12,1,1,1,17,129,0,13,1,17,0,0,0,0,0,0,0,0,0,0,0,0,0,152,0,0,0,0,152,153,0,132,173,0,0,0,0,0,0,0,0,0,0,79,1,1,3,4,4,4,5,1,1,1,0,0,
1,1,1,19,9,9,9,9,9,9,9,9,20,151,8,9,9,9,9,9,9,9,9,9,10,1,1,1,17,0,128,13,2,17,0,0,0,0,0,0,0,0,0,0,0,0,0,152,0,0,0,0,152,152,0,80,75,0,0,0,0,0,0,0,0,0,0,79,1,4,4,4,4,4,4,4,5,1,0,0,
1,1,1,1,1,1,1,1,1,1,1,1,69,150,67,1,1,1,1,1,1,1,1,1,1,1,1,1,17,0,128,13,1,17,140,137,0,0,0,0,0,0,0,0,0,0,0,152,0,82,82,0,153,152,0,78,77,0,0,0,0,0,0,0,0,0,0,73,73,73,82,73,82,73,82,5,1,1,0,0,
0,0,0,1,1,1,1,1,1,1,1,1,69,150,67,1,1,1,1,5,1,1,1,1,1,1,1,1,17,0,0,13,1,17,0,0,0,0,0,0,0,0,0,0,0,161,0,152,0,0,121,0,153,152,0,0,0,146,0,0,0,0,0,0,0,0,0,0,0,0,0,0,0,0,79,1,1,1,0,0,
0,0,0,0,0,0,0,0,0,0,0,1,70,150,68,1,1,1,1,1,1,1,1,1,1,1,1,1,17,0,0,11,15,18,137,136,0,0,0,0,0,0,0,0,82,82,0,152,0,0,169,0,152,152,0,0,0,145,0,0,0,0,0,0,0,0,0,0,0,0,0,0,0,0,79,1,1,1,0,0,
0,0,0,0,0,0,0,0,0,0,0,1,1,149,1,1,1,1,1,1,1,1,1,1,1,1,1,1,17,0,0,0,176,0,0,132,0,172,0,127,173,0,0,0,121,0,0,152,0,0,0,0,152,152,0,0,0,145,0,0,0,127,167,0,0,0,0,0,0,0,0,0,0,0,79,1,1,1,0,0,
0,0,0,0,0,0,0,0,0,0,0,1,1,1,1,1,1,1,1,1,1,1,1,1,1,1,1,1,65,73,73,73,73,82,73,9,73,9,73,9,9,20,0,0,0,0,154,155,156,0,0,154,155,155,156,0,0,147,0,146,0,8,20,0,0,0,0,0,0,0,0,0,0,0,79,2,1,1,0,0,
0,0,0,0,0,0,0,0,0,0,0,0,0,0,0,0,0,0,0,0,0,0,0,0,0,0,1,1,1,1,1,1,1,1,1,1,1,1,1,1,1,69,148,148,148,148,157,151,158,148,148,157,151,151,158,148,148,151,148,151,148,67,17,0,0,0,0,0,0,0,0,0,0,0,79,1,1,1,0,0,
0,0,0,0,0,0,0,0,0,0,0,0,0,0,0,0,0,0,0,0,0,0,0,0,0,0,0,0,0,0,0,0,0,0,0,0,0,0,0,1,1,69,150,150,150,150,150,150,150,150,150,150,150,150,150,150,150,150,150,150,150,67,17,0,0,0,0,0,0,0,123,0,0,0,79,1,3,1,0,0,
0,0,0,0,0,0,0,0,0,0,0,0,0,0,0,0,0,0,0,0,0,0,0,0,0,0,0,0,0,0,0,0,0,0,0,0,0,0,0,1,1,70,150,150,150,150,150,150,150,150,149,150,150,150,150,150,150,150,150,150,150,67,17,0,0,0,0,0,0,0,124,125,0,0,79,1,6,1,0,0,
0,0,0,0,0,0,0,0,0,0,0,0,0,0,0,0,0,0,0,0,0,0,0,0,0,0,0,0,0,0,0,0,0,0,0,0,0,0,0,1,1,1,149,150,149,150,150,149,150,149,1,150,150,150,150,150,150,150,150,150,150,68,17,0,0,0,0,0,0,0,124,124,0,0,79,1,1,1,0,0,
0,0,0,0,0,0,0,0,0,0,0,0,0,0,0,0,0,0,0,0,0,0,0,0,0,0,0,0,0,0,0,0,0,0,0,0,0,0,0,1,1,1,1,149,1,150,149,1,149,1,1,149,150,149,150,149,150,150,150,149,149,1,17,0,0,0,0,0,0,0,0,124,0,0,79,1,1,1,0,0,
0,0,0,0,0,0,0,0,0,0,0,0,0,0,0,0,0,0,0,0,0,0,0,0,0,0,0,0,1,1,1,1,1,0,0,0,0,0,0,1,1,1,1,1,1,149,1,1,1,1,1,1,149,1,149,1,149,150,149,1,1,1,17,0,0,0,0,0,0,0,0,0,0,0,79,1,1,0,0,0,
0,0,0,0,0,0,0,0,0,0,0,0,0,0,0,0,0,0,0,0,0,0,0,0,0,0,0,0,1,1,61,7,1,0,0,0,0,0,0,1,1,1,1,1,1,1,1,1,1,1,1,1,1,1,1,1,1,149,1,1,1,1,17,0,0,0,0,0,0,0,0,0,0,0,79,1,1,0,0,0,
0,0,0,0,0,0,0,0,0,0,0,0,0,0,0,0,0,0,0,0,0,0,0,0,0,0,0,0,1,63,146,60,1,1,1,1,0,0,0,1,1,1,1,1,1,1,1,1,1,1,1,1,1,1,1,1,1,1,1,1,1,1,17,0,0,0,0,0,0,0,0,0,0,0,79,1,1,0,0,0,
0,0,0,0,0,0,0,0,1,1,1,1,1,1,1,1,1,1,1,1,1,1,1,1,1,1,1,1,1,63,145,60,1,1,1,1,1,1,1,1,1,1,1,1,1,1,1,1,1,1,1,1,1,1,1,1,1,106,0,0,123,13,17,0,0,0,137,0,0,0,0,0,0,0,79,1,1,0,0,0,
0,0,0,0,0,0,0,0,1,1,61,61,61,61,61,61,61,61,1,1,61,61,61,61,61,61,61,61,61,64,145,59,61,61,61,61,61,61,61,1,1,1,1,1,1,1,1,1,1,1,1,1,1,1,1,1,1,76,124,134,0,12,17,0,138,138,0,0,0,0,0,0,0,0,79,1,1,0,0,0,
0,0,0,0,0,0,0,0,1,63,170,121,0,0,121,0,0,171,60,63,124,125,0,0,0,0,0,121,121,0,145,0,121,121,0,0,0,0,121,60,1,1,1,1,1,1,1,2,1,1,1,1,1,1,1,1,1,76,125,132,125,12,17,0,0,139,0,0,0,0,0,0,0,0,79,1,1,0,0,0,
0,0,0,0,0,0,0,0,1,63,0,121,0,0,0,0,0,124,60,63,124,124,0,0,0,0,0,0,121,0,145,0,121,121,0,0,0,0,121,60,5,61,15,15,61,61,61,61,61,61,15,61,15,61,15,15,14,19,20,0,8,10,17,0,0,0,0,0,0,0,0,0,0,0,79,1,1,0,0,0,
0,0,0,0,0,0,0,0,1,63,0,121,124,125,0,0,123,124,60,63,124,124,125,0,0,123,124,125,0,0,145,0,121,121,0,0,0,0,121,60,63,170,0,0,121,0,121,0,121,0,0,121,0,121,0,171,13,1,19,9,10,7,17,0,0,0,0,0,0,0,0,0,0,0,79,1,1,0,0,0,
0,0,0,0,0,0,0,0,1,63,0,121,124,124,0,123,124,124,60,63,124,124,124,125,0,146,0,0,134,0,145,0,121,121,0,0,0,0,121,60,63,0,0,0,159,0,121,0,121,0,0,121,0,121,0,0,11,15,15,15,15,15,18,0,0,0,0,0,0,0,0,0,0,0,79,1,1,0,0,0,
0,0,0,0,0,0,0,0,1,63,0,121,125,124,123,124,124,121,59,64,124,125,124,124,0,145,0,121,132,0,145,0,121,121,0,0,0,0,159,60,63,0,0,0,0,0,121,0,121,0,0,121,0,121,0,0,0,0,0,0,176,0,0,0,0,0,0,0,0,0,0,135,0,0,79,1,1,0,0,0,
0,0,0,0,0,0,0,0,1,63,0,168,0,125,124,124,0,121,0,0,0,0,121,121,0,145,0,121,121,0,145,0,121,121,0,0,0,0,0,59,64,0,0,0,123,0,168,0,121,0,0,168,0,121,0,0,0,0,80,73,73,73,75,0,135,0,0,0,135,0,0,132,0,0,79,1,1,0,0,0,
0,0,0,0,0,0,0,0,1,63,0,0,0,0,0,0,0,159,0,0,134,0,0,121,0,145,0,25,31,0,145,0,121,121,0,133,0,0,0,37,37,0,0,125,124,0,0,0,168,0,0,0,0,168,0,0,0,0,79,1,1,3,76,0,132,0,0,0,132,0,0,0,0,0,79,3,1,0,0,0,
0,0,0,0,0,0,0,0,1,63,0,0,0,161,0,162,161,0,0,178,132,0,0,0,0,145,0,33,35,0,145,0,25,31,0,0,173,178,0,37,37,0,0,0,0,178,0,174,0,0,0,0,0,0,0,0,0,0,79,1,3,7,65,73,73,73,73,73,73,73,73,73,73,73,58,1,1,0,0,0,
0,0,0,0,0,0,0,0,1,1,66,22,62,62,62,62,62,62,62,66,0,0,0,0,0,147,0,0,0,0,147,0,33,35,0,57,62,62,62,62,73,73,73,73,73,73,73,73,73,73,73,73,73,73,73,73,73,73,58,1,1,1,1,1,1,1,1,1,3,1,1,1,1,1,1,1,1,0,0,0,
0,0,0,0,0,0,0,0,1,1,63,24,60,1,1,1,1,1,1,69,148,148,148,148,148,151,148,148,148,148,151,148,148,148,148,67,1,1,1,1,1,1,1,1,1,1,1,1,1,1,1,1,1,1,1,1,1,1,1,1,1,1,1,1,1,1,1,1,5,1,1,1,1,1,1,1,1,0,0,0,
0,0,0,0,0,0,0,0,1,1,63,0,60,1,1,1,0,0,1,69,150,150,150,150,150,150,150,150,150,150,150,150,150,150,150,67,1,1,1,1,1,1,1,1,1,1,1,1,1,1,1,1,1,1,1,1,1,1,1,1,1,1,1,1,1,1,1,1,1,1,1,1,1,1,1,0,0,0,0,0,
0,0,0,0,0,0,0,0,1,1,63,0,60,1,1,1,0,0,1,69,150,150,150,150,150,150,150,150,150,150,150,150,150,150,150,67,1,0,0,0,0,0,0,1,1,1,1,1,1,1,1,1,1,1,1,84,84,84,84,84,84,84,84,84,84,84,84,84,84,84,84,84,84,1,1,0,0,0,0,0,
0,0,0,0,0,0,0,0,1,1,63,0,60,3,4,1,0,0,1,70,150,150,149,150,150,150,150,150,150,149,150,150,149,150,150,68,1,0,0,0,0,0,0,1,1,7,1,4,4,3,4,5,4,1,90,0,0,0,0,0,0,0,0,0,0,0,0,0,0,0,0,0,0,87,1,0,0,0,0,0,
0,0,0,0,0,0,0,0,1,1,63,0,60,4,1,1,0,0,1,1,149,150,1,149,149,150,149,150,150,1,149,150,1,150,149,1,1,0,0,0,0,0,0,1,4,4,4,6,4,4,4,1,1,1,90,0,0,0,0,0,0,0,0,0,0,0,0,0,0,0,0,0,0,87,1,0,0,0,0,0,
0,0,0,0,0,0,0,0,1,1,63,0,60,1,1,0,0,0,1,1,1,149,1,1,1,149,1,149,150,1,1,149,1,149,1,1,1,0,0,0,0,0,0,1,1,4,3,90,151,87,1,1,1,1,90,0,159,0,0,0,0,0,0,0,0,0,0,0,0,0,0,0,0,87,1,0,0,0,0,0,
0,0,0,0,0,0,0,0,1,1,63,0,60,1,1,0,0,0,1,1,1,1,1,1,1,1,1,1,149,1,1,1,1,1,1,1,1,0,0,0,0,0,0,1,1,1,1,90,152,87,1,1,1,4,90,0,143,133,0,0,0,133,0,0,133,0,0,0,0,0,0,0,0,87,1,0,0,0,0,0,
0,0,0,0,0,0,0,0,1,1,63,0,60,1,1,0,0,0,1,1,1,1,1,1,1,1,1,1,1,1,1,1,1,1,1,1,1,0,0,0,0,0,0,1,1,1,1,90,152,87,1,1,1,7,90,161,142,132,179,0,0,132,161,162,132,0,176,181,0,0,0,123,0,87,1,0,0,0,0,0,
0,0,0,0,0,0,0,0,1,7,63,0,60,1,1,0,0,0,0,0,0,0,0,0,0,0,0,0,0,0,0,0,0,0,0,0,0,1,1,1,1,1,1,1,1,1,1,90,152,87,1,1,1,5,91,83,83,62,92,25,31,85,83,83,83,83,83,83,92,0,0,125,0,87,1,1,0,0,0,0,
0,0,0,0,0,0,0,0,1,5,63,133,60,4,1,0,0,0,0,0,0,0,0,0,0,0,0,0,0,0,0,0,0,0,0,0,0,6,4,84,84,84,84,84,84,84,84,89,152,88,84,84,84,84,84,84,84,84,89,33,35,88,84,84,1,1,1,1,90,0,0,0,0,87,1,1,0,0,0,0,
0,0,0,0,0,0,0,0,1,1,63,132,60,5,1,1,1,1,1,1,1,1,1,1,1,1,1,1,1,1,1,1,1,1,1,1,1,4,90,170,0,0,0,0,0,0,0,0,152,0,0,0,0,0,0,0,0,0,0,0,0,0,0,0,87,1,1,1,76,82,0,133,0,87,1,1,0,0,0,0,
0,0,0,0,0,0,0,0,1,1,63,0,60,1,1,1,1,1,1,1,1,1,1,1,1,1,1,1,1,1,1,1,1,1,5,84,84,84,89,0,0,0,0,0,0,0,0,0,152,0,0,0,0,0,0,0,0,0,0,0,0,0,0,0,87,1,1,1,76,170,0,132,0,87,3,1,0,0,0,0,
0,0,0,0,0,0,0,0,1,1,63,0,60,5,1,1,1,5,84,84,84,84,84,84,84,84,84,84,84,84,84,84,84,84,89,0,0,0,0,0,0,0,0,0,0,0,0,0,152,0,0,122,0,0,0,0,0,0,0,0,0,0,0,0,87,1,1,1,90,0,0,0,0,87,1,1,0,0,0,0,
0,0,0,0,0,0,0,0,1,1,63,0,60,4,1,1,1,90,0,0,0,0,0,0,0,0,0,0,0,0,0,0,0,0,0,0,0,0,0,0,0,0,0,0,0,0,0,0,152,0,0,121,0,0,0,0,38,0,0,0,0,0,0,0,87,1,1,1,90,0,133,0,82,79,1,1,0,0,0,0,
0,0,0,0,0,0,0,0,1,1,63,0,60,1,1,1,1,90,0,0,0,0,0,0,0,0,0,0,0,0,0,0,0,0,0,0,0,0,0,0,0,0,179,168,0,0,0,0,152,0,0,121,0,0,0,0,38,0,0,0,0,0,0,0,87,1,1,1,90,0,132,0,171,79,1,1,0,0,0,0,
0,0,0,0,0,0,0,0,1,1,63,0,60,1,1,1,1,90,0,0,0,0,0,0,0,0,0,0,0,0,0,0,0,0,0,0,0,0,0,0,0,0,85,92,0,0,0,0,152,0,0,121,0,122,0,0,38,0,0,0,0,0,0,0,87,1,1,1,90,0,123,0,0,87,1,1,0,0,0,0,
0,0,0,0,0,0,0,0,1,1,63,0,60,1,1,1,1,90,0,0,0,0,0,0,0,0,0,0,0,0,122,0,0,0,0,0,0,0,0,0,0,0,87,90,0,0,0,0,152,0,0,159,0,121,0,0,38,122,0,0,0,0,0,0,88,84,84,84,89,0,124,126,0,87,4,1,0,0,0,0,
0,0,0,0,0,0,0,0,1,1,63,0,60,1,1,1,3,90,0,0,0,0,0,0,0,0,0,0,0,0,121,0,0,0,0,0,0,0,0,0,0,0,87,90,0,0,0,0,152,0,0,121,0,121,0,0,38,121,0,0,0,0,0,0,38,0,0,0,0,0,124,124,0,87,6,1,0,0,0,0,
0,0,0,0,0,0,0,0,1,1,63,0,60,4,4,4,4,90,0,0,0,0,0,0,0,0,0,0,0,0,121,0,0,0,0,0,0,0,0,0,0,0,87,90,0,0,0,0,152,0,0,121,0,168,0,0,0,168,0,0,180,0,0,0,38,0,0,133,0,0,125,124,123,87,4,1,0,0,0,0,
0,0,0,0,0,0,0,0,1,1,90,0,60,5,4,7,4,63,0,0,0,0,0,0,0,0,0,0,0,0,168,0,0,0,0,0,0,0,0,0,0,0,88,89,0,0,0,0,152,0,0,121,0,0,0,0,0,121,0,26,32,0,0,0,38,0,0,132,0,161,0,123,126,87,1,1,0,0,0,0,
0,0,0,0,0,0,0,0,1,1,64,0,59,84,84,84,84,89,0,0,0,0,0,0,0,0,0,0,0,0,0,146,0,144,179,0,0,0,0,0,0,0,0,0,0,0,0,0,152,0,0,121,0,0,0,0,0,121,0,32,36,0,0,0,85,83,83,83,83,83,73,73,73,86,1,1,0,0,0,0,
0,61,61,61,61,61,0,0,1,63,170,0,0,0,0,0,0,0,0,0,0,0,0,0,0,0,0,0,0,146,0,145,85,83,83,92,0,0,0,0,0,0,0,0,0,0,0,0,153,0,0,168,0,0,0,0,0,168,0,0,0,0,0,0,87,1,1,1,1,1,1,1,1,1,1,1,0,0,0,0,
63,0,0,82,0,0,78,61,61,64,0,0,0,0,0,0,0,0,0,0,0,0,0,0,0,168,0,146,0,145,0,145,88,84,84,89,0,0,0,0,0,0,0,0,0,0,0,0,152,0,0,0,0,0,179,0,0,0,0,0,0,0,0,0,87,4,5,1,1,1,0,0,0,0,0,0,0,0,0,0,
63,0,0,94,0,0,121,0,0,0,0,0,0,133,0,0,0,0,0,133,0,0,0,85,83,92,0,145,0,145,0,145,143,0,143,0,0,0,26,22,22,22,22,22,22,22,22,32,152,26,22,22,22,22,22,22,22,32,0,0,0,0,0,0,88,84,84,84,6,1,0,0,0,0,0,0,0,0,0,0,
63,0,0,94,0,0,163,0,0,0,0,176,0,132,144,0,172,0,173,132,0,0,0,88,84,89,0,145,0,145,0,145,0,0,0,0,0,0,32,24,24,24,24,24,24,24,24,36,152,32,24,24,24,24,24,24,24,36,0,0,0,0,0,0,0,0,0,0,87,1,0,0,0,0,0,0,0,0,0,0,
63,182,0,94,168,0,0,0,0,57,83,83,83,83,83,83,83,83,83,92,0,0,0,142,0,143,0,145,0,145,0,145,0,0,0,0,0,0,0,0,0,0,0,0,0,0,0,0,153,0,0,0,0,0,0,0,0,0,0,0,0,0,0,0,0,0,0,0,87,1,0,0,0,0,0,0,0,0,0,0,
65,62,62,62,62,62,62,62,62,58,1,1,1,1,1,1,1,1,1,90,0,0,0,0,0,0,0,145,0,145,0,145,0,0,0,0,0,0,0,0,0,0,0,0,0,0,0,0,153,0,0,0,0,0,0,0,0,0,0,146,0,0,0,0,0,0,0,0,87,1,0,0,0,0,0,0,0,0,0,0,
0,0,0,0,0,0,0,0,0,0,0,0,0,0,0,0,0,0,1,90,0,0,0,0,0,0,0,145,0,145,0,145,0,0,0,0,0,0,0,0,0,0,0,0,0,0,0,0,152,0,0,0,0,0,0,0,0,0,0,145,0,0,0,0,0,0,0,0,87,1,0,0,0,0,0,0,0,0,0,0,
0,0,0,0,0,0,0,0,0,0,0,0,0,0,0,0,0,0,1,90,0,0,0,0,0,0,0,145,0,145,0,145,0,0,0,0,0,0,0,0,0,0,0,0,0,0,0,0,153,0,0,0,0,0,0,0,126,124,125,145,123,124,124,0,0,0,0,0,87,1,0,0,0,0,0,0,0,0,0,0,
0,0,0,0,0,0,0,0,0,0,0,0,0,0,0,0,0,0,1,90,0,0,0,0,0,0,0,145,0,145,0,145,0,0,0,0,0,0,0,0,0,0,0,0,0,0,0,0,152,0,0,0,0,124,126,124,124,124,124,145,124,124,124,0,0,0,0,0,87,1,0,0,0,0,0,0,0,0,0,0,
0,0,0,0,0,0,0,0,0,0,0,0,0,0,0,0,0,0,1,90,0,0,0,0,0,0,0,145,0,145,0,145,0,0,0,0,0,0,0,0,0,0,0,0,0,0,0,0,152,0,0,0,0,125,124,124,124,124,123,145,125,124,124,0,0,0,0,0,87,1,0,0,0,0,0,0,0,0,0,0,
0,0,0,0,0,0,0,0,0,0,0,0,0,0,0,0,0,0,1,90,0,0,0,0,0,0,0,147,0,147,0,147,0,0,0,0,0,0,0,0,0,0,0,0,0,0,0,154,155,156,0,0,0,0,0,0,0,0,0,147,0,0,0,0,0,0,0,0,87,1,0,0,0,0,0,0,0,0,0,0,
0,0,0,0,0,0,0,0,0,0,0,0,0,0,0,0,0,0,1,69,148,148,148,148,148,148,148,151,148,151,148,151,148,148,148,148,148,148,148,148,148,148,148,148,148,148,148,157,151,158,148,148,148,148,148,148,148,148,148,151,148,148,148,148,148,148,148,148,67,1,0,0,0,0,0,0,0,0,0,0,
0,0,0,0,0,0,0,0,0,0,0,0,0,0,0,0,0,0,1,69,150,150,150,150,150,150,150,150,150,150,150,150,150,150,150,150,150,150,150,150,150,150,150,150,150,150,150,150,150,150,150,150,150,150,150,150,150,150,150,150,150,150,150,150,150,150,150,150,67,1,0,0,0,0,0,0,0,0,0,0,
0,0,0,0,0,0,0,0,0,0,0,0,0,0,0,0,0,0,1,70,150,150,150,150,150,150,150,150,150,150,150,150,150,150,150,150,150,150,150,150,150,150,150,150,150,150,150,150,150,150,150,150,150,150,150,150,150,150,150,150,150,150,150,150,150,150,150,150,67,1,0,0,0,0,0,0,0,0,0,0,
0,0,0,0,0,0,0,0,0,0,0,0,0,0,0,0,0,0,0,1,149,150,150,150,150,150,150,150,150,150,150,150,150,150,150,150,150,150,150,150,150,150,150,150,150,150,150,150,150,150,150,150,150,150,150,150,150,150,150,150,150,150,150,150,150,149,150,150,68,1,0,0,0,0,0,0,0,0,0,0,
0,0,0,0,0,0,0,0,0,0,0,0,0,0,0,0,0,0,0,1,1,149,150,149,150,149,150,149,150,150,149,150,149,150,149,150,150,149,150,150,150,149,150,150,149,150,149,150,149,150,149,150,150,149,150,149,150,149,150,149,150,149,150,150,150,0,150,149,1,1,0,0,0,0,0,0,0,0,0,0,
0,0,0,0,0,0,0,0,0,0,0,0,0,0,0,0,0,0,0,0,1,1,149,1,150,1,149,1,149,150,0,150,0,149,0,149,150,0,0,150,149,0,150,149,0,149,0,150,0,149,0,150,149,0,149,0,150,1,149,0,149,0,150,150,149,0,149,0,1,1,0,0,0,0,0,0,0,0,0,0,
0,0,0,0,0,0,0,0,0,0,0,0,0,0,0,0,0,0,0,0,0,1,1,1,149,1,1,1,1,149,0,149,0,0,0,0,149,0,0,149,0,0,149,0,0,0,0,149,0,0,0,149,0,1,0,0,149,1,1,0,0,0,149,150,1,1,1,1,1,1,0,0,0,0,0,0,0,0,0,0,
0,0,0,0,0,0,0,0,0,0,0,0,0,0,0,0,0,0,0,0,0,0,0,1,1,1,1,1,1,1,1,1,1,1,1,1,1,1,1,1,1,1,1,1,1,1,1,1,1,1,1,1,1,1,1,1,1,1,1,1,1,1,1,149,1,0,0,0,0,0,0,0,0,0,0,0,0,0,0,0,
0,0,0,0,0,0,0,0,0,0,0,0,0,0,0,0,0,0,0,0,0,0,0,0,0,0,0,0,0,0,0,0,0,0,0,0,0,0,0,0,0,0,0,0,0,0,0,0,0,0,0,0,0,0,0,0,0,0,0,0,0,0,1,1,1,0,0,0,0,0,0,0,0,0,0,0,0,0,0,0,
