80
80
0,0,0,0,0,0,0,0,0,0,0,0,0,0,0,0,0,0,0,0,0,0,8,9,9,9,9,9,9,9,9,9,20,0,127,0,0,0,0,0,0,0,0,0,0,0,0,0,0,0,0,0,0,0,0,0,0,0,0,0,0,0,0,0,0,0,0,0,0,0,0,0,0,0,0,0,0,0,0,0,
0,0,0,127,0,127,0,127,127,0,0,0,0,0,0,0,0,0,0,0,0,0,11,14,1,1,1,1,3,1,1,1,19,9,9,20,0,0,0,0,0,0,0,0,0,0,0,0,0,0,0,0,0,0,0,0,0,0,0,0,0,0,0,0,0,0,0,0,0,127,0,0,0,0,0,0,0,0,0,0,
8,9,9,9,9,9,9,9,20,0,0,0,0,0,0,0,0,0,0,0,0,0,0,11,15,15,15,15,15,15,15,15,3,14,15,18,129,0,0,0,0,0,0,0,0,0,0,0,0,0,0,0,0,0,0,0,0,0,0,0,0,0,0,0,0,80,73,73,73,9,73,73,9,9,73,73,73,9,73,73,
12,1,1,1,6,1,14,15,18,0,0,0,0,0,0,0,0,0,0,0,0,0,0,0,0,131,0,0,131,0,0,0,12,17,0,0,0,0,0,0,0,0,0,0,0,0,0,0,0,0,0,0,0,0,0,0,0,0,0,0,0,0,0,0,0,79,7,1,1,1,1,1,1,1,1,1,1,1,1,1,
12,1,1,1,15,15,18,10,0,0,0,0,0,0,0,0,0,137,140,0,0,0,0,0,0,0,0,0,0,0,0,0,12,17,0,0,0,0,0,0,0,0,0,0,0,0,0,0,0,0,0,0,0,0,0,0,0,0,0,0,0,0,0,0,0,78,61,6,1,1,1,1,1,1,1,0,0,0,0,0,
12,1,1,16,130,130,130,0,0,0,0,0,0,0,0,0,0,0,139,137,138,137,0,0,127,127,127,167,127,0,0,0,12,17,0,0,0,0,0,0,0,0,0,0,0,0,0,0,0,0,0,0,0,0,0,0,0,0,0,0,0,0,0,0,0,0,0,79,1,1,1,1,1,1,1,0,0,0,0,0,
13,1,1,18,0,0,0,0,0,0,0,0,0,0,0,0,0,0,0,138,138,139,0,0,8,9,9,9,20,0,0,128,12,16,0,0,0,0,0,0,0,0,0,0,0,0,0,151,0,0,0,0,0,0,0,0,0,0,0,0,0,0,0,0,0,0,0,79,1,2,1,1,1,1,1,0,0,0,0,0,
12,1,17,0,0,0,0,0,140,138,0,0,0,0,0,0,0,0,0,0,0,0,0,0,12,3,1,1,17,129,0,0,12,17,0,0,0,0,0,0,0,0,0,0,0,0,0,152,0,0,0,0,0,0,0,0,0,0,0,0,0,0,0,0,0,0,0,79,1,6,1,1,1,1,1,0,0,0,0,0,
12,1,17,0,0,0,0,138,137,0,0,0,0,0,0,0,0,0,0,0,0,0,0,128,12,1,1,1,17,0,135,128,13,17,0,0,0,0,0,0,0,0,0,0,0,0,0,152,0,0,0,0,151,151,0,0,0,0,0,0,0,0,0,0,0,0,0,79,1,1,1,1,1,1,1,0,0,0,0,0,
13,1,17,0,0,0,0,0,0,0,0,0,0,0,0,0,0,0,0,0,0,0,0,0,13,1,1,14,17,129,132,0,12,17,0,0,0,0,0,0,0,0,0,0,0,0,0,152,0,0,0,0,152,152,0,0,0,0,0,0,0,0,0,0,0,0,0,79,2,1,1,1,1,1,1,0,0,0,0,0,
12,1,16,0,0,0,0,0,0,0,0,0,0,146,0,0,0,0,0,0,0,0,0,0,12,1,1,1,16,0,0,128,12,17,0,0,0,0,0,0,0,0,0,0,0,0,0,152,0,0,0,0,152,152,0,0,0,0,0,0,0,0,0,0,0,0,0,79,7,1,1,1,1,1,1,1,0,0,0,0,
13,1,17,0,0,0,136,0,0,136,0,0,0,145,0,136,0,0,136,0,0,0,0,0,13,1,1,1,17,129,0,0,12,17,0,0,0,0,0,0,0,0,0,0,0,0,0,152,0,0,0,0,152,152,0,0,0,0,0,0,0,0,0,0,0,0,0,79,1,1,1,1,1,1,1,1,0,0,0,0,
12,1,17,127,0,0,132,0,0,132,0,0,0,145,0,132,0,0,132,0,0,0,0,128,12,1,1,1,17,0,0,8,10,17,129,0,0,0,0,0,0,0,0,0,0,0,0,152,0,0,0,0,152,153,0,134,0,0,0,0,0,0,0,0,0,0,0,79,1,1,1,1,5,1,1,1,0,0,0,0,
12,1,19,20,127,127,127,177,127,175,127,172,0,145,166,127,127,175,175,127,173,127,175,0,12,1,1,1,17,129,0,13,1,17,0,0,0,0,0,0,0,0,0,0,0,0,0,152,0,0,0,0,152,153,0,132,173,0,0,0,0,0,0,0,0,0,0,79,1,1,3,4,4,4,5,1,1,1,0,0,
1,1,1,19,9,9,9,9,9,9,9,9,20,151,8,9,9,9,9,9,9,9,9,9,10,1,1,1,17,0,128,13,2,17,0,0,0,0,0,0,0,0,0,0,0,0,0,152,0,0,0,0,152,152,0,80,75,0,0,0,0,0,0,0,0,0,0,79,1,4,4,4,4,4,4,4,5,1,0,0,
1,1,1,1,1,1,1,1,1,1,1,1,69,150,67,1,1,1,1,1,1,1,1,1,1,1,1,1,17,0,128,13,1,17,0,0,0,0,0,0,0,0,0,0,0,0,0,152,0,82,82,0,153,152,0,78,77,0,0,0,0,0,0,0,0,0,0,73,73,73,82,73,82,73,82,5,1,1,0,0,
0,0,0,1,1,1,1,1,1,1,1,1,69,150,67,1,1,1,1,5,1,1,1,1,1,1,1,1,17,0,0,13,1,17,0,0,0,0,0,0,0,0,0,0,0,161,0,152,0,0,121,0,153,152,0,0,0,146,0,0,0,0,0,0,0,0,0,0,0,0,0,0,0,0,79,1,1,1,0,0,
0,0,0,0,0,0,0,0,0,0,0,1,70,150,68,1,1,1,1,1,1,1,1,1,1,1,1,1,17,0,0,11,15,18,137,136,0,0,0,0,0,0,0,0,82,82,0,152,0,0,169,0,152,152,0,0,0,145,0,0,0,0,0,0,0,0,0,0,0,0,0,0,0,0,79,1,1,1,0,0,
0,0,0,0,0,0,0,0,0,0,0,1,1,149,1,1,1,1,1,1,1,1,1,1,1,1,1,1,17,0,0,0,176,0,0,132,0,172,0,127,173,0,0,0,121,0,0,152,0,0,0,0,152,152,0,0,0,145,0,0,0,127,167,0,0,0,0,0,0,0,0,0,0,0,79,1,1,1,0,0,
0,0,0,0,0,0,0,0,0,0,0,1,1,1,1,1,1,1,1,1,1,1,1,1,1,1,1,1,65,73,73,73,73,82,73,9,73,9,73,9,9,20,0,0,0,0,154,155,156,0,0,154,155,155,156,0,0,147,0,146,0,8,20,0,0,0,0,0,0,0,0,0,0,0,79,2,1,1,0,0,
0,0,0,0,0,0,0,0,0,0,0,0,0,0,0,0,0,0,0,0,0,0,0,0,0,0,1,1,1,1,1,1,1,1,1,1,1,1,1,1,1,69,148,148,148,148,157,151,158,148,148,157,151,151,158,148,148,151,148,151,148,67,17,0,0,0,0,0,0,0,0,0,0,0,79,1,1,1,0,0,
0,0,0,0,0,0,0,0,0,0,0,0,0,0,0,0,0,0,0,0,0,0,0,0,0,0,0,0,0,0,0,0,0,0,0,0,0,0,0,1,1,69,150,150,150,150,150,150,150,150,150,150,150,150,150,150,150,150,150,150,150,67,17,0,0,0,0,0,0,0,123,0,0,0,79,1,3,1,0,0,
0,0,0,0,0,0,0,0,0,0,0,0,0,0,0,0,0,0,0,0,0,0,0,0,0,0,0,0,0,0,0,0,0,0,0,0,0,0,0,1,1,70,150,150,150,150,150,150,150,150,149,150,150,150,150,150,150,150,150,150,150,67,17,0,0,0,0,0,0,0,124,125,0,0,79,1,6,1,0,0,
0,0,0,0,0,0,0,0,0,0,0,0,0,0,0,0,0,0,0,0,0,0,0,0,0,0,0,0,0,0,0,0,0,0,0,0,0,0,0,1,1,1,149,150,149,150,150,149,150,149,1,150,150,150,150,150,150,150,150,150,150,68,17,0,0,0,0,0,0,0,124,124,0,0,79,1,1,1,0,0,
0,0,0,0,0,0,0,0,0,0,0,0,0,0,0,0,0,0,0,0,0,0,0,0,0,0,0,0,0,0,0,0,0,0,0,0,0,0,0,1,1,1,1,149,1,150,149,1,149,1,1,149,150,149,150,149,150,150,150,149,149,1,17,0,0,0,0,0,0,0,0,124,0,0,79,1,1,1,0,0,
0,0,0,0,0,0,0,0,0,0,0,0,0,0,0,0,0,0,0,0,0,0,0,0,0,0,0,0,1,1,1,1,1,0,0,0,0,0,0,1,1,1,1,1,1,149,1,1,1,1,1,1,149,1,149,1,149,150,149,1,1,1,17,0,0,0,0,0,0,0,0,0,0,0,79,1,1,0,0,0,
0,0,0,0,0,0,0,0,0,0,0,0,0,0,0,0,0,0,0,0,0,0,0,0,0,0,0,0,1,1,61,7,1,0,0,0,0,0,0,1,1,1,1,1,1,1,1,1,1,1,1,1,1,1,1,1,1,149,1,1,1,1,17,0,0,0,0,0,0,0,0,0,0,0,79,1,1,0,0,0,
0,0,0,0,0,0,0,0,0,0,0,0,0,0,0,0,0,0,0,0,0,0,0,0,0,0,0,0,1,63,146,60,1,1,1,1,0,0,0,1,1,1,1,1,1,1,1,1,1,1,1,1,1,1,1,1,1,1,1,1,1,1,17,0,0,0,0,0,0,0,0,0,0,0,79,1,1,0,0,0,
0,0,0,0,0,0,0,0,1,1,1,1,1,1,1,1,1,1,1,1,1,1,1,1,1,1,1,1,1,63,145,60,1,1,1,1,1,1,1,1,1,1,1,1,1,1,1,1,1,1,1,1,1,1,1,1,1,16,125,0,123,13,17,0,0,0,137,0,0,0,0,0,0,0,79,1,1,0,0,0,
0,0,0,0,0,0,0,0,1,1,61,61,61,61,61,61,61,61,1,1,1,61,61,61,61,61,61,61,61,64,145,59,61,61,61,61,61,61,61,1,1,1,1,1,1,1,1,1,1,1,1,1,1,1,1,1,1,17,124,134,0,12,17,0,138,138,0,0,0,0,0,0,0,0,79,1,1,0,0,0,
0,0,0,0,0,0,0,0,1,63,170,121,0,0,121,0,0,171,60,1,63,125,0,0,0,0,0,121,121,0,145,0,121,121,0,0,0,0,121,60,1,1,1,1,1,1,1,2,1,1,1,1,1,1,1,1,1,17,125,132,125,12,17,0,0,139,0,0,0,0,0,0,0,0,79,1,1,0,0,0,
0,0,0,0,0,0,0,0,1,63,0,121,0,0,0,0,0,124,60,1,63,124,0,0,0,0,0,0,121,0,145,0,121,121,0,0,0,0,121,60,5,61,15,15,61,61,61,61,61,61,15,61,15,61,15,15,14,19,20,0,8,10,17,0,0,0,0,0,0,0,0,0,0,0,79,1,1,0,0,0,
0,0,0,0,0,0,0,0,1,63,0,121,124,125,0,0,123,124,60,1,63,124,125,0,0,123,124,125,0,0,145,0,121,121,0,0,0,0,121,60,63,170,0,0,121,0,121,0,121,0,0,121,0,121,0,171,13,1,19,9,10,7,17,0,0,0,0,0,0,0,0,0,0,0,79,1,1,0,0,0,
0,0,0,0,0,0,0,0,1,63,0,121,124,124,0,123,124,0,60,1,63,124,124,125,0,146,0,0,134,0,145,0,121,121,0,0,0,0,121,60,63,0,0,0,159,0,121,0,121,0,0,121,0,121,0,0,11,15,15,15,15,15,18,0,0,0,0,0,0,0,0,0,0,0,79,1,1,0,0,0,
0,0,0,0,0,0,0,0,1,63,0,121,125,124,123,124,124,0,59,61,64,125,124,124,0,145,0,121,132,0,145,0,121,121,0,0,0,0,159,60,63,0,0,0,0,0,121,0,121,0,0,121,0,121,0,0,0,0,0,0,176,0,0,0,0,0,0,0,0,0,0,135,0,0,79,1,1,0,0,0,
0,0,0,0,0,0,0,0,1,63,0,168,0,125,124,124,0,0,0,0,0,0,121,121,0,145,0,121,121,0,145,0,121,121,0,0,0,0,0,59,64,0,0,0,0,0,168,0,121,0,0,168,0,121,0,0,0,0,80,73,73,73,75,0,135,0,0,0,135,0,0,132,0,0,79,1,1,0,0,0,
0,0,0,0,0,0,0,0,1,63,0,0,0,0,0,0,0,0,0,0,134,0,0,121,0,145,0,25,31,0,145,0,121,121,0,133,0,0,0,37,37,0,0,0,0,0,0,0,168,0,0,0,0,168,0,0,0,0,79,1,1,3,76,0,132,0,0,0,132,0,0,0,0,0,79,3,1,0,0,0,
0,0,0,0,0,0,0,0,1,63,0,0,0,161,0,162,161,0,0,0,132,0,0,0,0,145,0,33,35,0,145,0,25,31,0,0,173,0,0,37,37,0,0,0,0,0,0,174,0,0,0,0,0,0,0,0,0,0,79,1,3,7,65,73,73,73,73,73,73,73,73,73,73,73,58,1,1,0,0,0,
0,0,0,0,0,0,0,0,1,1,62,62,62,62,62,62,62,62,62,66,0,0,0,0,0,147,0,0,0,0,147,0,33,35,0,57,62,62,62,62,73,73,73,73,73,73,73,73,73,73,73,73,73,73,73,73,73,73,58,1,1,1,1,1,1,1,1,1,3,1,1,1,1,1,1,1,1,0,0,0,
0,0,0,0,0,0,0,0,1,1,1,1,1,1,1,1,1,1,1,69,148,148,148,148,148,151,148,148,148,148,151,148,148,148,148,67,1,1,1,1,1,1,1,1,1,1,1,1,1,1,1,1,1,1,1,1,1,1,1,1,1,1,1,1,1,1,1,1,5,1,1,1,1,1,1,1,1,0,0,0,
0,0,0,0,0,0,0,0,0,0,0,0,0,0,0,0,0,0,0,69,150,150,150,150,150,150,150,150,150,150,150,150,150,150,150,67,1,0,0,0,0,0,0,0,0,0,0,0,0,0,0,0,0,0,0,0,0,0,0,0,0,0,0,0,0,0,0,0,0,0,0,0,0,0,0,0,0,0,0,0,
0,0,0,0,0,0,0,0,0,0,0,0,0,0,0,0,0,0,0,69,150,150,150,150,150,150,150,150,150,150,150,150,150,150,150,67,1,0,0,0,0,0,0,0,0,0,0,0,0,0,0,0,0,0,0,0,0,0,0,0,0,0,0,0,0,0,0,0,0,0,0,0,0,0,0,0,0,0,0,0,
0,0,0,0,0,0,0,0,0,0,0,0,0,0,0,0,0,0,0,70,150,150,149,150,150,150,150,150,150,149,150,150,149,150,150,68,1,0,0,0,0,0,0,0,0,0,0,0,0,0,0,0,0,0,0,0,0,0,0,0,0,0,0,0,0,0,0,0,0,0,0,0,0,0,0,0,0,0,0,0,
0,0,0,0,0,0,0,0,0,0,0,0,0,0,0,0,0,0,0,1,149,150,1,149,149,150,149,150,150,1,149,150,1,150,149,1,1,0,0,0,0,0,0,0,0,0,0,0,0,0,0,0,0,0,0,0,0,0,0,0,0,0,0,0,0,0,0,0,0,0,0,0,0,0,0,0,0,0,0,0,
0,0,0,0,0,0,0,0,0,0,0,0,0,0,0,0,0,0,0,1,1,149,1,1,1,149,1,149,150,1,1,149,1,149,1,1,1,0,0,0,0,0,0,0,0,0,0,0,0,0,0,0,0,0,0,0,0,0,0,0,0,0,0,0,0,0,0,0,0,0,0,0,0,0,0,0,0,0,0,0,
0,0,0,0,0,0,0,0,0,0,0,0,0,0,0,0,0,0,0,1,1,1,1,1,1,1,1,1,149,1,1,1,1,1,1,1,1,0,0,0,0,0,0,0,0,0,0,0,0,0,0,0,0,0,0,0,0,0,0,0,0,0,0,0,0,0,0,0,0,0,0,0,0,0,0,0,0,0,0,0,
0,0,0,0,0,0,0,0,0,0,0,0,0,0,0,0,0,0,0,1,1,1,1,1,1,1,1,1,1,1,1,1,1,1,1,1,1,0,0,0,0,0,0,0,0,0,0,0,0,0,0,0,0,0,0,0,0,0,0,0,0,0,0,0,0,0,0,0,0,0,0,0,0,0,0,0,0,0,0,0,
0,0,0,0,0,0,0,0,0,0,0,0,0,0,0,0,0,0,0,0,0,0,0,0,0,0,0,0,0,0,0,0,0,0,0,0,0,0,0,0,0,0,0,0,0,0,0,0,0,0,0,0,0,0,0,0,0,0,0,0,0,0,0,0,0,0,0,0,0,0,0,0,0,0,0,0,0,0,0,0,
0,0,0,0,0,0,0,0,0,0,0,0,0,0,0,0,0,0,0,0,0,0,0,0,0,0,0,0,0,0,0,0,0,0,0,0,0,0,0,0,0,0,0,0,0,0,0,0,0,0,0,0,0,0,0,0,0,0,0,0,0,0,0,0,0,0,0,0,0,0,0,0,0,0,0,0,0,0,0,0,
0,0,0,0,0,0,0,0,0,0,0,0,0,0,0,0,0,0,0,0,0,0,0,0,0,0,0,0,0,0,0,0,0,0,0,0,0,0,0,0,0,0,0,0,0,0,0,0,0,0,0,0,0,0,0,0,0,0,0,0,0,0,0,0,0,0,0,0,0,0,0,0,0,0,0,0,0,0,0,0,
0,0,0,0,0,0,0,0,0,0,0,0,0,0,0,0,0,0,0,0,0,0,0,0,0,0,0,0,0,0,0,0,0,0,0,0,0,0,0,0,0,0,0,0,0,0,0,0,0,0,0,0,0,0,0,0,0,0,0,0,0,0,0,0,0,0,0,0,0,0,0,0,0,0,0,0,0,0,0,0,
0,0,0,0,0,0,0,0,0,0,0,0,0,0,0,0,0,0,0,0,0,0,0,0,0,0,0,0,0,0,0,0,0,0,0,0,0,0,0,0,0,0,0,0,0,0,0,0,0,0,0,0,0,0,0,0,0,0,0,0,0,0,0,0,0,0,0,0,0,0,0,0,0,0,0,0,0,0,0,0,
0,0,0,0,0,0,0,0,0,0,0,0,0,0,0,0,0,0,0,0,0,0,0,0,0,0,0,0,0,0,0,0,0,0,0,0,0,0,0,0,0,0,0,0,0,0,0,0,0,0,0,0,0,0,0,0,0,0,0,0,0,0,0,0,0,0,0,0,0,0,0,0,0,0,0,0,0,0,0,0,
0,0,0,0,0,0,0,0,0,0,0,0,0,0,0,0,0,0,0,0,0,0,0,0,0,0,0,0,0,0,0,0,0,0,0,0,0,0,0,0,0,0,0,0,0,0,0,0,0,0,0,0,0,0,0,0,0,0,0,0,0,0,0,0,0,0,0,0,0,0,0,0,0,0,0,0,0,0,0,0,
0,0,0,0,0,0,0,0,0,0,0,0,0,0,0,0,0,0,0,0,0,0,0,0,0,0,0,0,0,0,0,0,0,0,0,0,0,0,0,0,0,0,0,0,0,0,0,0,0,0,0,0,0,0,0,0,0,0,0,0,0,0,0,0,0,0,0,0,0,0,0,0,0,0,0,0,0,0,0,0,
0,0,0,0,0,0,0,0,0,0,0,0,0,0,0,0,0,0,0,0,0,0,0,0,0,0,0,0,0,0,0,0,0,0,0,0,0,0,0,0,0,0,0,0,0,0,0,0,0,0,0,0,0,0,0,0,0,0,0,0,0,0,0,0,0,0,0,0,0,0,0,0,0,0,0,0,0,0,0,0,
0,0,0,0,0,0,0,0,0,0,0,0,0,0,0,0,0,0,0,0,0,0,0,0,0,0,0,0,0,0,0,0,0,0,0,0,0,0,0,0,0,0,0,0,0,0,0,0,0,0,0,0,0,0,0,0,0,0,0,0,0,0,0,0,0,0,0,0,0,0,0,0,0,0,0,0,0,0,0,0,
0,0,0,0,0,0,0,0,0,0,0,0,0,0,0,0,0,0,0,0,0,0,0,0,0,0,0,0,0,0,0,0,0,0,0,0,0,0,0,0,0,0,0,0,0,0,0,0,0,0,0,0,0,0,0,0,0,0,0,0,0,0,0,0,0,0,0,0,0,0,0,0,0,0,0,0,0,0,0,0,
0,0,0,0,0,0,0,0,0,0,0,0,0,0,0,0,0,0,0,0,0,0,0,0,0,0,0,0,0,0,0,0,0,0,0,0,0,0,0,0,0,0,0,0,0,0,0,0,0,0,0,0,0,0,0,0,0,0,0,0,0,0,0,0,0,0,0,0,0,0,0,0,0,0,0,0,0,0,0,0,
0,0,0,0,0,0,0,0,0,0,0,0,0,0,0,0,0,0,0,0,0,0,0,0,0,0,0,0,0,0,0,0,0,0,0,0,0,0,0,0,0,0,0,0,0,0,0,0,0,0,0,0,0,0,0,0,0,0,0,0,0,0,0,0,0,0,0,0,0,0,0,0,0,0,0,0,0,0,0,0,
0,0,0,0,0,0,0,0,0,0,0,0,0,0,0,0,0,0,0,0,0,0,0,0,0,0,0,0,0,0,0,0,0,0,0,0,0,0,0,0,0,0,0,0,0,0,0,0,0,0,0,0,0,0,0,0,0,0,0,0,0,0,0,0,0,0,0,0,0,0,0,0,0,0,0,0,0,0,0,0,
0,0,0,0,0,0,0,0,0,0,0,0,0,0,0,0,0,0,0,0,0,0,0,0,0,0,0,0,0,0,0,0,0,0,0,0,0,0,0,0,0,0,0,0,0,0,0,0,0,0,0,0,0,0,0,0,0,0,0,0,0,0,0,0,0,0,0,0,0,0,0,0,0,0,0,0,0,0,0,0,
0,0,0,0,0,0,0,0,0,0,0,0,0,0,0,0,0,0,0,0,0,0,0,0,0,0,0,0,0,0,0,0,0,0,0,0,0,0,0,0,0,0,0,0,0,0,0,0,0,0,0,0,0,0,0,0,0,0,0,0,0,0,0,0,0,0,0,0,0,0,0,0,0,0,0,0,0,0,0,0,
0,0,0,0,0,0,0,0,0,0,0,0,0,0,0,0,0,0,0,0,0,0,0,0,0,0,0,0,0,0,0,0,0,0,0,0,0,0,0,0,0,0,0,0,0,0,0,0,0,0,0,0,0,0,0,0,0,0,0,0,0,0,0,0,0,0,0,0,0,0,0,0,0,0,0,0,0,0,0,0,
0,0,0,0,0,0,0,0,0,0,0,0,0,0,0,0,0,0,0,0,0,0,0,0,0,0,0,0,0,0,0,0,0,0,0,0,0,0,0,0,0,0,0,0,0,0,0,0,0,0,0,0,0,0,0,0,0,0,0,0,0,0,0,0,0,0,0,0,0,0,0,0,0,0,0,0,0,0,0,0,
0,0,0,0,0,0,0,0,0,0,0,0,0,0,0,0,0,0,0,0,0,0,0,0,0,0,0,0,0,0,0,0,0,0,0,0,0,0,0,0,0,0,0,0,0,0,0,0,0,0,0,0,0,0,0,0,0,0,0,0,0,0,0,0,0,0,0,0,0,0,0,0,0,0,0,0,0,0,0,0,
0,0,0,0,0,0,0,0,0,0,0,0,0,0,0,0,0,0,0,0,0,0,0,0,0,0,0,0,0,0,0,0,0,0,0,0,0,0,0,0,0,0,0,0,0,0,0,0,0,0,0,0,0,0,0,0,0,0,0,0,0,0,0,0,0,0,0,0,0,0,0,0,0,0,0,0,0,0,0,0,
0,0,0,0,0,0,0,0,0,0,0,0,0,0,0,0,0,0,0,0,0,0,0,0,0,0,0,0,0,0,0,0,0,0,0,0,0,0,0,0,0,0,0,0,0,0,0,0,0,0,0,0,0,0,0,0,0,0,0,0,0,0,0,0,0,0,0,0,0,0,0,0,0,0,0,0,0,0,0,0,
0,0,0,0,0,0,0,0,0,0,0,0,0,0,0,0,0,0,0,0,0,0,0,0,0,0,0,0,0,0,0,0,0,0,0,0,0,0,0,0,0,0,0,0,0,0,0,0,0,0,0,0,0,0,0,0,0,0,0,0,0,0,0,0,0,0,0,0,0,0,0,0,0,0,0,0,0,0,0,0,
0,0,0,0,0,0,0,0,0,0,0,0,0,0,0,0,0,0,0,0,0,0,0,0,0,0,0,0,0,0,0,0,0,0,0,0,0,0,0,0,0,0,0,0,0,0,0,0,0,0,0,0,0,0,0,0,0,0,0,0,0,0,0,0,0,0,0,0,0,0,0,0,0,0,0,0,0,0,0,0,
0,0,0,0,0,0,0,0,0,0,0,0,0,0,0,0,0,0,0,0,0,0,0,0,0,0,0,0,0,0,0,0,0,0,0,0,0,0,0,0,0,0,0,0,0,0,0,0,0,0,0,0,0,0,0,0,0,0,0,0,0,0,0,0,0,0,0,0,0,0,0,0,0,0,0,0,0,0,0,0,
0,0,0,0,0,0,0,0,0,0,0,0,0,0,0,0,0,0,0,0,0,0,0,0,0,0,0,0,0,0,0,0,0,0,0,0,0,0,0,0,0,0,0,0,0,0,0,0,0,0,0,0,0,0,0,0,0,0,0,0,0,0,0,0,0,0,0,0,0,0,0,0,0,0,0,0,0,0,0,0,
0,0,0,0,0,0,0,0,0,0,0,0,0,0,0,0,0,0,0,0,0,0,0,0,0,0,0,0,0,0,0,0,0,0,0,0,0,0,0,0,0,0,0,0,0,0,0,0,0,0,0,0,0,0,0,0,0,0,0,0,0,0,0,0,0,0,0,0,0,0,0,0,0,0,0,0,0,0,0,0,
0,0,0,0,0,0,0,0,0,0,0,0,0,0,0,0,0,0,0,0,0,0,0,0,0,0,0,0,0,0,0,0,0,0,0,0,0,0,0,0,0,0,0,0,0,0,0,0,0,0,0,0,0,0,0,0,0,0,0,0,0,0,0,0,0,0,0,0,0,0,0,0,0,0,0,0,0,0,0,0,
0,0,0,0,0,0,0,0,0,0,0,0,0,0,0,0,0,0,0,0,0,0,0,0,0,0,0,0,0,0,0,0,0,0,0,0,0,0,0,0,0,0,0,0,0,0,0,0,0,0,0,0,0,0,0,0,0,0,0,0,0,0,0,0,0,0,0,0,0,0,0,0,0,0,0,0,0,0,0,0,
0,0,0,0,0,0,0,0,0,0,0,0,0,0,0,0,0,0,0,0,0,0,0,0,0,0,0,0,0,0,0,0,0,0,0,0,0,0,0,0,0,0,0,0,0,0,0,0,0,0,0,0,0,0,0,0,0,0,0,0,0,0,0,0,0,0,0,0,0,0,0,0,0,0,0,0,0,0,0,0,
0,0,0,0,0,0,0,0,0,0,0,0,0,0,0,0,0,0,0,0,0,0,0,0,0,0,0,0,0,0,0,0,0,0,0,0,0,0,0,0,0,0,0,0,0,0,0,0,0,0,0,0,0,0,0,0,0,0,0,0,0,0,0,0,0,0,0,0,0,0,0,0,0,0,0,0,0,0,0,0,
0,0,0,0,0,0,0,0,0,0,0,0,0,0,0,0,0,0,0,0,0,0,0,0,0,0,0,0,0,0,0,0,0,0,0,0,0,0,0,0,0,0,0,0,0,0,0,0,0,0,0,0,0,0,0,0,0,0,0,0,0,0,0,0,0,0,0,0,0,0,0,0,0,0,0,0,0,0,0,0,
0,0,0,0,0,0,0,0,0,0,0,0,0,0,0,0,0,0,0,0,0,0,0,0,0,0,0,0,0,0,0,0,0,0,0,0,0,0,0,0,0,0,0,0,0,0,0,0,0,0,0,0,0,0,0,0,0,0,0,0,0,0,0,0,0,0,0,0,0,0,0,0,0,0,0,0,0,0,0,0,
0,0,0,0,0,0,0,0,0,0,0,0,0,0,0,0,0,0,0,0,0,0,0,0,0,0,0,0,0,0,0,0,0,0,0,0,0,0,0,0,0,0,0,0,0,0,0,0,0,0,0,0,0,0,0,0,0,0,0,0,0,0,0,0,0,0,0,0,0,0,0,0,0,0,0,0,0,0,0,0,
